State Code,District Code,Area Name,Total/ Rural/ Urban,Age-group,Number speaking second language (Persons),Number speaking second language (Males),Number speaking second language (Females),Number speaking third language (Persons) ,Number speaking third language (Males) ,Number speaking third language (Females)
00,00,INDIA,Total,Total,314988770,176696383,138292387,86009580,50536832,35472748
00,00,INDIA,Total,5-9,15649192,8166843,7482349,1844108,978151,865957
00,00,INDIA,Total,10-14,34488492,18133423,16355069,7254335,3831131,3423204
00,00,INDIA,Total,15-19,42424599,22750908,19673691,12626717,6792766,5833951
00,00,INDIA,Total,20-24,41344406,22386694,18957712,12834334,7067614,5766720
00,00,INDIA,Total,25-29,35924045,19695033,16229012,10857171,6144045,4713126
00,00,INDIA,Total,30-49,96443870,55866320,40577550,27466884,16824473,10642411
00,00,INDIA,Total,50-69,39729782,24306735,15423047,10916361,7385967,3530394
00,00,INDIA,Total,70+,7962347,4813671,3148676,1954539,1362695,591844
00,00,INDIA,Total,Age not stated,1022037,576756,445281,255131,149990,105141
00,00,INDIA,Rural,Total,162641485,92988052,69653433,35383989,21771062,13612927
00,00,INDIA,Rural,5-9,9292251,4815380,4476871,672498,356376,316122
00,00,INDIA,Rural,10-14,20960599,11005994,9954605,3638873,1929573,1709300
00,00,INDIA,Rural,15-19,24547666,13342296,11205370,6559688,3616092,2943596
00,00,INDIA,Rural,20-24,21905564,12180144,9725420,5966021,3449951,2516070
00,00,INDIA,Rural,25-29,18052954,10261185,7791769,4569413,2768678,1800735
00,00,INDIA,Rural,30-49,45973742,27687500,18286242,10139312,6778161,3361151
00,00,INDIA,Rural,50-69,17824491,11195472,6629019,3215504,2413157,802347
00,00,INDIA,Rural,70+,3635989,2240389,1395600,534536,404113,130423
00,00,INDIA,Rural,Age not stated,448229,259692,188537,88144,54961,33183
00,00,INDIA,Urban,Total,152347285,83708331,68638954,50625591,28765770,21859821
00,00,INDIA,Urban,5-9,6356941,3351463,3005478,1171610,621775,549835
00,00,INDIA,Urban,10-14,13527893,7127429,6400464,3615462,1901558,1713904
00,00,INDIA,Urban,15-19,17876933,9408612,8468321,6067029,3176674,2890355
00,00,INDIA,Urban,20-24,19438842,10206550,9232292,6868313,3617663,3250650
00,00,INDIA,Urban,25-29,17871091,9433848,8437243,6287758,3375367,2912391
00,00,INDIA,Urban,30-49,50470128,28178820,22291308,17327572,10046312,7281260
00,00,INDIA,Urban,50-69,21905291,13111263,8794028,7700857,4972810,2728047
00,00,INDIA,Urban,70+,4326358,2573282,1753076,1420003,958582,461421
00,00,INDIA,Urban,Age not stated,573808,317064,256744,166987,95029,71958
01,00,JAMMU & KASHMIR,Total,Total,6183190,3634819,2548371,2096220,1258756,837464
01,00,JAMMU & KASHMIR,Total,5-9,436543,234697,201846,73589,39782,33807
01,00,JAMMU & KASHMIR,Total,10-14,905370,487358,418012,222586,121618,100968
01,00,JAMMU & KASHMIR,Total,15-19,902124,488112,414012,339152,187145,152007
01,00,JAMMU & KASHMIR,Total,20-24,806741,449407,357334,343400,191644,151756
01,00,JAMMU & KASHMIR,Total,25-29,699600,412076,287524,271949,157424,114525
01,00,JAMMU & KASHMIR,Total,30-49,1716078,1079000,637078,607745,387660,220085
01,00,JAMMU & KASHMIR,Total,50-69,587421,398116,189305,202306,147122,55184
01,00,JAMMU & KASHMIR,Total,70+,124212,82839,41373,33910,25382,8528
01,00,JAMMU & KASHMIR,Total,Age not stated,5101,3214,1887,1583,979,604
01,00,JAMMU & KASHMIR,Rural,Total,4167238,2470363,1696875,1258724,778704,480020
01,00,JAMMU & KASHMIR,Rural,5-9,321318,172729,148589,52954,28627,24327
01,00,JAMMU & KASHMIR,Rural,10-14,685252,369310,315942,162463,89191,73272
01,00,JAMMU & KASHMIR,Rural,15-19,659476,359506,299970,230865,130000,100865
01,00,JAMMU & KASHMIR,Rural,20-24,553103,310502,242601,215100,124592,90508
01,00,JAMMU & KASHMIR,Rural,25-29,450347,266157,184190,156318,94469,61849
01,00,JAMMU & KASHMIR,Rural,30-49,1071778,691411,380367,329557,224256,105301
01,00,JAMMU & KASHMIR,Rural,50-69,346003,246213,99790,94087,74449,19638
01,00,JAMMU & KASHMIR,Rural,70+,76464,52373,24091,16289,12406,3883
01,00,JAMMU & KASHMIR,Rural,Age not stated,3497,2162,1335,1091,714,377
01,00,JAMMU & KASHMIR,Urban,Total,2015952,1164456,851496,837496,480052,357444
01,00,JAMMU & KASHMIR,Urban,5-9,115225,61968,53257,20635,11155,9480
01,00,JAMMU & KASHMIR,Urban,10-14,220118,118048,102070,60123,32427,27696
01,00,JAMMU & KASHMIR,Urban,15-19,242648,128606,114042,108287,57145,51142
01,00,JAMMU & KASHMIR,Urban,20-24,253638,138905,114733,128300,67052,61248
01,00,JAMMU & KASHMIR,Urban,25-29,249253,145919,103334,115631,62955,52676
01,00,JAMMU & KASHMIR,Urban,30-49,644300,387589,256711,278188,163404,114784
01,00,JAMMU & KASHMIR,Urban,50-69,241418,151903,89515,108219,72673,35546
01,00,JAMMU & KASHMIR,Urban,70+,47748,30466,17282,17621,12976,4645
01,00,JAMMU & KASHMIR,Urban,Age not stated,1604,1052,552,492,265,227
02,00,HIMACHAL PRADESH,Total,Total,1242705,683966,558739,347286,200478,146808
02,00,HIMACHAL PRADESH,Total,5-9,66049,35154,30895,6545,3640,2905
02,00,HIMACHAL PRADESH,Total,10-14,128097,68993,59104,29483,15935,13548
02,00,HIMACHAL PRADESH,Total,15-19,149568,79647,69921,51298,26777,24521
02,00,HIMACHAL PRADESH,Total,20-24,156207,81346,74861,52839,27019,25820
02,00,HIMACHAL PRADESH,Total,25-29,140198,72598,67600,45565,23722,21843
02,00,HIMACHAL PRADESH,Total,30-49,402317,221249,181068,112797,66731,46066
02,00,HIMACHAL PRADESH,Total,50-69,162339,100542,61797,40987,30350,10637
02,00,HIMACHAL PRADESH,Total,70+,36536,23637,12899,7396,6089,1307
02,00,HIMACHAL PRADESH,Total,Age not stated,1394,800,594,376,215,161
02,00,HIMACHAL PRADESH,Rural,Total,981518,538801,442717,280817,163039,117778
02,00,HIMACHAL PRADESH,Rural,5-9,54665,28986,25679,5197,2871,2326
02,00,HIMACHAL PRADESH,Rural,10-14,104609,55817,48792,24871,13369,11502
02,00,HIMACHAL PRADESH,Rural,15-19,120883,63911,56972,44018,22842,21176
02,00,HIMACHAL PRADESH,Rural,20-24,124900,64349,60551,44980,22873,22107
02,00,HIMACHAL PRADESH,Rural,25-29,110781,56663,54118,37965,19738,18227
02,00,HIMACHAL PRADESH,Rural,30-49,311727,171675,140052,89215,53849,35366
02,00,HIMACHAL PRADESH,Rural,50-69,124081,77926,46155,29264,23010,6254
02,00,HIMACHAL PRADESH,Rural,70+,28720,18814,9906,4985,4304,681
02,00,HIMACHAL PRADESH,Rural,Age not stated,1152,660,492,322,183,139
02,00,HIMACHAL PRADESH,Urban,Total,261187,145165,116022,66469,37439,29030
02,00,HIMACHAL PRADESH,Urban,5-9,11384,6168,5216,1348,769,579
02,00,HIMACHAL PRADESH,Urban,10-14,23488,13176,10312,4612,2566,2046
02,00,HIMACHAL PRADESH,Urban,15-19,28685,15736,12949,7280,3935,3345
02,00,HIMACHAL PRADESH,Urban,20-24,31307,16997,14310,7859,4146,3713
02,00,HIMACHAL PRADESH,Urban,25-29,29417,15935,13482,7600,3984,3616
02,00,HIMACHAL PRADESH,Urban,30-49,90590,49574,41016,23582,12882,10700
02,00,HIMACHAL PRADESH,Urban,50-69,38258,22616,15642,11723,7340,4383
02,00,HIMACHAL PRADESH,Urban,70+,7816,4823,2993,2411,1785,626
02,00,HIMACHAL PRADESH,Urban,Age not stated,242,140,102,54,32,22
03,00,PUNJAB,Total,Total,13035224,7284183,5751041,7829913,4383841,3446072
03,00,PUNJAB,Total,5-9,469117,258821,210296,182720,101811,80909
03,00,PUNJAB,Total,10-14,1422222,791025,631197,737273,408297,328976
03,00,PUNJAB,Total,15-19,1939641,1069343,870298,1289483,700576,588907
03,00,PUNJAB,Total,20-24,1866086,982349,883737,1267339,653430,613909
03,00,PUNJAB,Total,25-29,1552503,816854,735649,1002556,517566,484990
03,00,PUNJAB,Total,30-49,3929497,2186501,1742996,2322915,1306172,1016743
03,00,PUNJAB,Total,50-69,1566940,982119,584821,881384,586330,295054
03,00,PUNJAB,Total,70+,274136,188970,85166,137067,104602,32465
03,00,PUNJAB,Total,Age not stated,15082,8201,6881,9176,5057,4119
03,00,PUNJAB,Rural,Total,7083180,3998260,3084920,4230870,2404467,1826403
03,00,PUNJAB,Rural,5-9,218735,119765,98970,85168,47132,38036
03,00,PUNJAB,Rural,10-14,858482,474042,384440,441821,241904,199917
03,00,PUNJAB,Rural,15-19,1221923,670139,551784,814423,440271,374152
03,00,PUNJAB,Rural,20-24,1105218,574901,530317,752594,384833,367761
03,00,PUNJAB,Rural,25-29,856668,447252,409416,553822,286558,267264
03,00,PUNJAB,Rural,30-49,2019252,1152336,866916,1169080,688702,480378
03,00,PUNJAB,Rural,50-69,675066,463921,211145,351988,264840,87148
03,00,PUNJAB,Rural,70+,118180,90600,27580,55969,46863,9106
03,00,PUNJAB,Rural,Age not stated,9656,5304,4352,6005,3364,2641
03,00,PUNJAB,Urban,Total,5952044,3285923,2666121,3599043,1979374,1619669
03,00,PUNJAB,Urban,5-9,250382,139056,111326,97552,54679,42873
03,00,PUNJAB,Urban,10-14,563740,316983,246757,295452,166393,129059
03,00,PUNJAB,Urban,15-19,717718,399204,318514,475060,260305,214755
03,00,PUNJAB,Urban,20-24,760868,407448,353420,514745,268597,246148
03,00,PUNJAB,Urban,25-29,695835,369602,326233,448734,231008,217726
03,00,PUNJAB,Urban,30-49,1910245,1034165,876080,1153835,617470,536365
03,00,PUNJAB,Urban,50-69,891874,518198,373676,529396,321490,207906
03,00,PUNJAB,Urban,70+,155956,98370,57586,81098,57739,23359
03,00,PUNJAB,Urban,Age not stated,5426,2897,2529,3171,1693,1478
04,00,CHANDIGARH,Total,Total,579920,322898,257022,321979,178557,143422
04,00,CHANDIGARH,Total,5-9,25605,14090,11515,8546,4769,3777
04,00,CHANDIGARH,Total,10-14,51841,29263,22578,27428,15536,11892
04,00,CHANDIGARH,Total,15-19,68806,38530,30276,41223,22603,18620
04,00,CHANDIGARH,Total,20-24,79255,43623,35632,46022,24462,21560
04,00,CHANDIGARH,Total,25-29,67799,37172,30627,37130,19888,17242
04,00,CHANDIGARH,Total,30-49,183014,100968,82046,97908,53148,44760
04,00,CHANDIGARH,Total,50-69,85686,48973,36713,52830,31082,21748
04,00,CHANDIGARH,Total,70+,17785,10210,7575,10827,7034,3793
04,00,CHANDIGARH,Total,Age not stated,129,69,60,65,35,30
04,00,CHANDIGARH,Rural,Total,11723,7069,4654,4353,2647,1706
04,00,CHANDIGARH,Rural,5-9,601,305,296,117,63,54
04,00,CHANDIGARH,Rural,10-14,1138,646,492,426,238,188
04,00,CHANDIGARH,Rural,15-19,1422,866,556,690,391,299
04,00,CHANDIGARH,Rural,20-24,1682,1026,656,713,413,300
04,00,CHANDIGARH,Rural,25-29,1790,1040,750,661,388,273
04,00,CHANDIGARH,Rural,30-49,3923,2460,1463,1375,872,503
04,00,CHANDIGARH,Rural,50-69,1012,626,386,323,241,82
04,00,CHANDIGARH,Rural,70+,152,98,54,45,39,6
04,00,CHANDIGARH,Rural,Age not stated,3,2,1,3,2,1
04,00,CHANDIGARH,Urban,Total,568197,315829,252368,317626,175910,141716
04,00,CHANDIGARH,Urban,5-9,25004,13785,11219,8429,4706,3723
04,00,CHANDIGARH,Urban,10-14,50703,28617,22086,27002,15298,11704
04,00,CHANDIGARH,Urban,15-19,67384,37664,29720,40533,22212,18321
04,00,CHANDIGARH,Urban,20-24,77573,42597,34976,45309,24049,21260
04,00,CHANDIGARH,Urban,25-29,66009,36132,29877,36469,19500,16969
04,00,CHANDIGARH,Urban,30-49,179091,98508,80583,96533,52276,44257
04,00,CHANDIGARH,Urban,50-69,84674,48347,36327,52507,30841,21666
04,00,CHANDIGARH,Urban,70+,17633,10112,7521,10782,6995,3787
04,00,CHANDIGARH,Urban,Age not stated,126,67,59,62,33,29
05,00,UTTARAKHAND,Total,Total,1757756,982762,774994,187822,109529,78293
05,00,UTTARAKHAND,Total,5-9,102038,53954,48084,4215,2203,2012
05,00,UTTARAKHAND,Total,10-14,197841,105926,91915,15904,8455,7449
05,00,UTTARAKHAND,Total,15-19,257667,138282,119385,29527,15281,14246
05,00,UTTARAKHAND,Total,20-24,246349,134185,112164,30022,16609,13413
05,00,UTTARAKHAND,Total,25-29,193562,105612,87950,22692,12905,9787
05,00,UTTARAKHAND,Total,30-49,499640,286633,213007,55013,33589,21424
05,00,UTTARAKHAND,Total,50-69,210390,127371,83019,24489,16063,8426
05,00,UTTARAKHAND,Total,70+,47308,29066,18242,5732,4297,1435
05,00,UTTARAKHAND,Total,Age not stated,2961,1733,1228,228,127,101
05,00,UTTARAKHAND,Rural,Total,835231,467968,367263,70611,42893,27718
05,00,UTTARAKHAND,Rural,5-9,57627,30381,27246,1803,938,865
05,00,UTTARAKHAND,Rural,10-14,107974,57095,50879,7482,3936,3546
05,00,UTTARAKHAND,Rural,15-19,133771,71401,62370,14319,7686,6633
05,00,UTTARAKHAND,Rural,20-24,116326,63329,52997,12656,7192,5464
05,00,UTTARAKHAND,Rural,25-29,86512,48421,38091,8638,5248,3390
05,00,UTTARAKHAND,Rural,30-49,221450,129825,91625,18177,12304,5873
05,00,UTTARAKHAND,Rural,50-69,89110,54017,35093,6182,4552,1630
05,00,UTTARAKHAND,Rural,70+,21325,12863,8462,1292,1010,282
05,00,UTTARAKHAND,Rural,Age not stated,1136,636,500,62,27,35
05,00,UTTARAKHAND,Urban,Total,922525,514794,407731,117211,66636,50575
05,00,UTTARAKHAND,Urban,5-9,44411,23573,20838,2412,1265,1147
05,00,UTTARAKHAND,Urban,10-14,89867,48831,41036,8422,4519,3903
05,00,UTTARAKHAND,Urban,15-19,123896,66881,57015,15208,7595,7613
05,00,UTTARAKHAND,Urban,20-24,130023,70856,59167,17366,9417,7949
05,00,UTTARAKHAND,Urban,25-29,107050,57191,49859,14054,7657,6397
05,00,UTTARAKHAND,Urban,30-49,278190,156808,121382,36836,21285,15551
05,00,UTTARAKHAND,Urban,50-69,121280,73354,47926,18307,11511,6796
05,00,UTTARAKHAND,Urban,70+,25983,16203,9780,4440,3287,1153
05,00,UTTARAKHAND,Urban,Age not stated,1825,1097,728,166,100,66
06,00,HARYANA,Total,Total,5627361,3257645,2369716,1170571,681228,489343
06,00,HARYANA,Total,5-9,232580,128807,103773,17696,9971,7725
06,00,HARYANA,Total,10-14,573540,321082,252458,97509,54690,42819
06,00,HARYANA,Total,15-19,843906,473191,370715,195948,107958,87990
06,00,HARYANA,Total,20-24,835396,457872,377524,187590,101018,86572
06,00,HARYANA,Total,25-29,689360,383152,306208,148462,81924,66538
06,00,HARYANA,Total,30-49,1653253,983243,670010,340304,202216,138088
06,00,HARYANA,Total,50-69,661002,421351,239651,152180,100145,52035
06,00,HARYANA,Total,70+,131886,85378,46508,29431,22475,6956
06,00,HARYANA,Total,Age not stated,6438,3569,2869,1451,831,620
06,00,HARYANA,Rural,Total,2757542,1651753,1105789,562967,344293,218674
06,00,HARYANA,Rural,5-9,132897,73068,59829,7186,4100,3086
06,00,HARYANA,Rural,10-14,344734,192287,152447,60140,33646,26494
06,00,HARYANA,Rural,15-19,498438,280067,218371,130066,72121,57945
06,00,HARYANA,Rural,20-24,449875,252150,197725,111679,61721,49958
06,00,HARYANA,Rural,25-29,332886,194716,138170,74716,44119,30597
06,00,HARYANA,Rural,30-49,708979,456123,252856,132932,90459,42473
06,00,HARYANA,Rural,50-69,237189,167562,69627,38681,31754,6927
06,00,HARYANA,Rural,70+,49155,33877,15278,6806,5926,880
06,00,HARYANA,Rural,Age not stated,3389,1903,1486,761,447,314
06,00,HARYANA,Urban,Total,2869819,1605892,1263927,607604,336935,270669
06,00,HARYANA,Urban,5-9,99683,55739,43944,10510,5871,4639
06,00,HARYANA,Urban,10-14,228806,128795,100011,37369,21044,16325
06,00,HARYANA,Urban,15-19,345468,193124,152344,65882,35837,30045
06,00,HARYANA,Urban,20-24,385521,205722,179799,75911,39297,36614
06,00,HARYANA,Urban,25-29,356474,188436,168038,73746,37805,35941
06,00,HARYANA,Urban,30-49,944274,527120,417154,207372,111757,95615
06,00,HARYANA,Urban,50-69,423813,253789,170024,113499,68391,45108
06,00,HARYANA,Urban,70+,82731,51501,31230,22625,16549,6076
06,00,HARYANA,Urban,Age not stated,3049,1666,1383,690,384,306
07,00,NCT OF DELHI,Total,Total,6817214,3792458,3024756,1358233,741513,616720
07,00,NCT OF DELHI,Total,5-9,238766,128912,109854,28514,15191,13323
07,00,NCT OF DELHI,Total,10-14,555125,301894,253231,86373,46106,40267
07,00,NCT OF DELHI,Total,15-19,823151,446795,376356,136451,71782,64669
07,00,NCT OF DELHI,Total,20-24,924887,496583,428304,159909,83191,76718
07,00,NCT OF DELHI,Total,25-29,849278,453395,395883,156480,80505,75975
07,00,NCT OF DELHI,Total,30-49,2265837,1280296,985541,469504,254280,215224
07,00,NCT OF DELHI,Total,50-69,957360,564671,392689,259634,149394,110240
07,00,NCT OF DELHI,Total,70+,197065,116713,80352,60443,40565,19878
07,00,NCT OF DELHI,Total,Age not stated,5745,3199,2546,925,499,426
07,00,NCT OF DELHI,Rural,Total,98713,59504,39209,5474,3336,2138
07,00,NCT OF DELHI,Rural,5-9,2446,1380,1066,54,26,28
07,00,NCT OF DELHI,Rural,10-14,8168,4571,3597,339,195,144
07,00,NCT OF DELHI,Rural,15-19,15734,8723,7011,839,453,386
07,00,NCT OF DELHI,Rural,20-24,17028,9354,7674,801,457,344
07,00,NCT OF DELHI,Rural,25-29,13829,7738,6091,726,406,320
07,00,NCT OF DELHI,Rural,30-49,30923,19859,11064,1856,1165,691
07,00,NCT OF DELHI,Rural,50-69,9112,6786,2326,684,484,200
07,00,NCT OF DELHI,Rural,70+,1364,1035,329,171,148,23
07,00,NCT OF DELHI,Rural,Age not stated,109,58,51,4,2,2
07,00,NCT OF DELHI,Urban,Total,6718501,3732954,2985547,1352759,738177,614582
07,00,NCT OF DELHI,Urban,5-9,236320,127532,108788,28460,15165,13295
07,00,NCT OF DELHI,Urban,10-14,546957,297323,249634,86034,45911,40123
07,00,NCT OF DELHI,Urban,15-19,807417,438072,369345,135612,71329,64283
07,00,NCT OF DELHI,Urban,20-24,907859,487229,420630,159108,82734,76374
07,00,NCT OF DELHI,Urban,25-29,835449,445657,389792,155754,80099,75655
07,00,NCT OF DELHI,Urban,30-49,2234914,1260437,974477,467648,253115,214533
07,00,NCT OF DELHI,Urban,50-69,948248,557885,390363,258950,148910,110040
07,00,NCT OF DELHI,Urban,70+,195701,115678,80023,60272,40417,19855
07,00,NCT OF DELHI,Urban,Age not stated,5636,3141,2495,921,497,424
08,00,RAJASTHAN,Total,Total,7473186,4389920,3083266,1006751,642842,363909
08,00,RAJASTHAN,Total,5-9,479152,255935,223217,15735,8683,7052
08,00,RAJASTHAN,Total,10-14,990049,538578,451471,103809,58369,45440
08,00,RAJASTHAN,Total,15-19,1152513,649652,502861,210941,123366,87575
08,00,RAJASTHAN,Total,20-24,1019958,595941,424017,176163,108655,67508
08,00,RAJASTHAN,Total,25-29,797895,475412,322483,121262,78232,43030
08,00,RAJASTHAN,Total,30-49,2056211,1263798,792413,270694,186443,84251
08,00,RAJASTHAN,Total,50-69,775108,489902,285206,87696,64186,23510
08,00,RAJASTHAN,Total,70+,164615,98868,65747,15322,11678,3644
08,00,RAJASTHAN,Total,Age not stated,37685,21834,15851,5129,3230,1899
08,00,RAJASTHAN,Rural,Total,4247026,2593810,1653216,609507,414618,194889
08,00,RAJASTHAN,Rural,5-9,329094,175601,153493,8525,4726,3799
08,00,RAJASTHAN,Rural,10-14,698265,381809,316456,76554,43641,32913
08,00,RAJASTHAN,Rural,15-19,742080,429111,312969,156426,94328,62098
08,00,RAJASTHAN,Rural,20-24,584061,364476,219585,116000,77047,38953
08,00,RAJASTHAN,Rural,25-29,421369,271819,149550,71287,51087,20200
08,00,RAJASTHAN,Rural,30-49,1027728,683719,344009,139446,109890,29556
08,00,RAJASTHAN,Rural,50-69,341692,226240,115452,32456,27362,5094
08,00,RAJASTHAN,Rural,70+,75250,44904,30346,5151,4146,1005
08,00,RAJASTHAN,Rural,Age not stated,27487,16131,11356,3662,2391,1271
08,00,RAJASTHAN,Urban,Total,3226160,1796110,1430050,397244,228224,169020
08,00,RAJASTHAN,Urban,5-9,150058,80334,69724,7210,3957,3253
08,00,RAJASTHAN,Urban,10-14,291784,156769,135015,27255,14728,12527
08,00,RAJASTHAN,Urban,15-19,410433,220541,189892,54515,29038,25477
08,00,RAJASTHAN,Urban,20-24,435897,231465,204432,60163,31608,28555
08,00,RAJASTHAN,Urban,25-29,376526,203593,172933,49975,27145,22830
08,00,RAJASTHAN,Urban,30-49,1028483,580079,448404,131248,76553,54695
08,00,RAJASTHAN,Urban,50-69,433416,263662,169754,55240,36824,18416
08,00,RAJASTHAN,Urban,70+,89365,53964,35401,10171,7532,2639
08,00,RAJASTHAN,Urban,Age not stated,10198,5703,4495,1467,839,628
09,00,UTTAR PRADESH,Total,Total,22873609,13309909,9563700,2585664,1546993,1038671
09,00,UTTAR PRADESH,Total,5-9,1162649,609337,553312,60460,31151,29309
09,00,UTTAR PRADESH,Total,10-14,2660707,1399022,1261685,269061,138833,130228
09,00,UTTAR PRADESH,Total,15-19,3892396,2072687,1819709,506007,263405,242602
09,00,UTTAR PRADESH,Total,20-24,3370804,1917920,1452884,429516,243722,185794
09,00,UTTAR PRADESH,Total,25-29,2409303,1383214,1026089,287802,169276,118526
09,00,UTTAR PRADESH,Total,30-49,6156770,3779258,2377512,678745,441130,237615
09,00,UTTAR PRADESH,Total,50-69,2500847,1681971,818876,277046,203414,73632
09,00,UTTAR PRADESH,Total,70+,520027,351679,168348,57610,44471,13139
09,00,UTTAR PRADESH,Total,Age not stated,200106,114821,85285,19417,11591,7826
09,00,UTTAR PRADESH,Rural,Total,10917897,6641168,4276729,1267848,814164,453684
09,00,UTTAR PRADESH,Rural,5-9,584448,305934,278514,26852,14020,12832
09,00,UTTAR PRADESH,Rural,10-14,1465761,773290,692471,159168,83682,75486
09,00,UTTAR PRADESH,Rural,15-19,2165225,1176809,988416,294526,159596,134930
09,00,UTTAR PRADESH,Rural,20-24,1660585,999825,660760,217320,133254,84066
09,00,UTTAR PRADESH,Rural,25-29,1086433,674005,412428,133506,87529,45977
09,00,UTTAR PRADESH,Rural,30-49,2649332,1772242,877090,298146,220876,77270
09,00,UTTAR PRADESH,Rural,50-69,1006581,733761,272820,108175,91502,16673
09,00,UTTAR PRADESH,Rural,70+,221561,157806,63755,21679,18233,3446
09,00,UTTAR PRADESH,Rural,Age not stated,77971,47496,30475,8476,5472,3004
09,00,UTTAR PRADESH,Urban,Total,11955712,6668741,5286971,1317816,732829,584987
09,00,UTTAR PRADESH,Urban,5-9,578201,303403,274798,33608,17131,16477
09,00,UTTAR PRADESH,Urban,10-14,1194946,625732,569214,109893,55151,54742
09,00,UTTAR PRADESH,Urban,15-19,1727171,895878,831293,211481,103809,107672
09,00,UTTAR PRADESH,Urban,20-24,1710219,918095,792124,212196,110468,101728
09,00,UTTAR PRADESH,Urban,25-29,1322870,709209,613661,154296,81747,72549
09,00,UTTAR PRADESH,Urban,30-49,3507438,2007016,1500422,380599,220254,160345
09,00,UTTAR PRADESH,Urban,50-69,1494266,948210,546056,168871,111912,56959
09,00,UTTAR PRADESH,Urban,70+,298466,193873,104593,35931,26238,9693
09,00,UTTAR PRADESH,Urban,Age not stated,122135,67325,54810,10941,6119,4822
10,00,BIHAR,Total,Total,16761785,9443495,7318290,1682572,1028475,654097
10,00,BIHAR,Total,5-9,1804831,936995,867836,93094,48296,44798
10,00,BIHAR,Total,10-14,2849005,1509745,1339260,261823,137806,124017
10,00,BIHAR,Total,15-19,2110349,1202181,908168,276454,156516,119938
10,00,BIHAR,Total,20-24,1729816,979405,750411,219430,132395,87035
10,00,BIHAR,Total,25-29,1541171,857828,683343,173385,105971,67414
10,00,BIHAR,Total,30-49,4397916,2543179,1854737,451722,296247,155475
10,00,BIHAR,Total,50-69,1896752,1145324,751428,171077,124939,46138
10,00,BIHAR,Total,70+,378285,238229,140056,30580,23246,7334
10,00,BIHAR,Total,Age not stated,53660,30609,23051,5007,3059,1948
10,00,BIHAR,Rural,Total,13930257,7865893,6064364,1262676,785074,477602
10,00,BIHAR,Rural,5-9,1594585,827417,767168,75186,39114,36072
10,00,BIHAR,Rural,10-14,2484014,1319835,1164179,213171,113165,100006
10,00,BIHAR,Rural,15-19,1731520,1000204,731316,211907,123240,88667
10,00,BIHAR,Rural,20-24,1394420,795121,599299,161918,100689,61229
10,00,BIHAR,Rural,25-29,1256179,702818,553361,127446,80188,47258
10,00,BIHAR,Rural,30-49,3577548,2077637,1499911,328222,220926,107296
10,00,BIHAR,Rural,50-69,1540918,924949,615969,119665,88939,30726
10,00,BIHAR,Rural,70+,310213,194592,115621,21787,16699,5088
10,00,BIHAR,Rural,Age not stated,40860,23320,17540,3374,2114,1260
10,00,BIHAR,Urban,Total,2831528,1577602,1253926,419896,243401,176495
10,00,BIHAR,Urban,5-9,210246,109578,100668,17908,9182,8726
10,00,BIHAR,Urban,10-14,364991,189910,175081,48652,24641,24011
10,00,BIHAR,Urban,15-19,378829,201977,176852,64547,33276,31271
10,00,BIHAR,Urban,20-24,335396,184284,151112,57512,31706,25806
10,00,BIHAR,Urban,25-29,284992,155010,129982,45939,25783,20156
10,00,BIHAR,Urban,30-49,820368,465542,354826,123500,75321,48179
10,00,BIHAR,Urban,50-69,355834,220375,135459,51412,36000,15412
10,00,BIHAR,Urban,70+,68072,43637,24435,8793,6547,2246
10,00,BIHAR,Urban,Age not stated,12800,7289,5511,1633,945,688
11,00,SIKKIM,Total,Total,388999,213340,175659,181402,99427,81975
11,00,SIKKIM,Total,5-9,21390,10734,10656,5788,2873,2915
11,00,SIKKIM,Total,10-14,46352,23122,23230,21665,10613,11052
11,00,SIKKIM,Total,15-19,53332,26689,26643,30656,14858,15798
11,00,SIKKIM,Total,20-24,53073,27753,25320,28271,14295,13976
11,00,SIKKIM,Total,25-29,50044,27282,22762,25399,13451,11948
11,00,SIKKIM,Total,30-49,117079,68014,49065,53862,32317,21545
11,00,SIKKIM,Total,50-69,38855,24236,14619,13550,9489,4061
11,00,SIKKIM,Total,70+,8159,5119,3040,1933,1373,560
11,00,SIKKIM,Total,Age not stated,715,391,324,278,158,120
11,00,SIKKIM,Rural,Total,274230,152062,122168,118176,65545,52631
11,00,SIKKIM,Rural,5-9,15385,7662,7723,3536,1716,1820
11,00,SIKKIM,Rural,10-14,34757,17355,17402,15422,7527,7895
11,00,SIKKIM,Rural,15-19,39574,19902,19672,22145,10722,11423
11,00,SIKKIM,Rural,20-24,38129,20220,17909,19388,9994,9394
11,00,SIKKIM,Rural,25-29,34774,19344,15430,16540,8915,7625
11,00,SIKKIM,Rural,30-49,78046,46309,31737,32330,20126,12204
11,00,SIKKIM,Rural,50-69,26795,16961,9834,7438,5550,1888
11,00,SIKKIM,Rural,70+,6182,3989,2193,1175,882,293
11,00,SIKKIM,Rural,Age not stated,588,320,268,202,113,89
11,00,SIKKIM,Urban,Total,114769,61278,53491,63226,33882,29344
11,00,SIKKIM,Urban,5-9,6005,3072,2933,2252,1157,1095
11,00,SIKKIM,Urban,10-14,11595,5767,5828,6243,3086,3157
11,00,SIKKIM,Urban,15-19,13758,6787,6971,8511,4136,4375
11,00,SIKKIM,Urban,20-24,14944,7533,7411,8883,4301,4582
11,00,SIKKIM,Urban,25-29,15270,7938,7332,8859,4536,4323
11,00,SIKKIM,Urban,30-49,39033,21705,17328,21532,12191,9341
11,00,SIKKIM,Urban,50-69,12060,7275,4785,6112,3939,2173
11,00,SIKKIM,Urban,70+,1977,1130,847,758,491,267
11,00,SIKKIM,Urban,Age not stated,127,71,56,76,45,31
12,00,ARUNACHAL PRADESH,Total,Total,885945,478413,407532,418551,236666,181885
12,00,ARUNACHAL PRADESH,Total,5-9,79172,40256,38916,22366,11463,10903
12,00,ARUNACHAL PRADESH,Total,10-14,139785,70697,69088,64679,32966,31713
12,00,ARUNACHAL PRADESH,Total,15-19,130096,65847,64249,74224,37805,36419
12,00,ARUNACHAL PRADESH,Total,20-24,107857,54808,53049,58807,30484,28323
12,00,ARUNACHAL PRADESH,Total,25-29,99297,52429,46868,51105,28120,22985
12,00,ARUNACHAL PRADESH,Total,30-49,251228,143572,107656,118602,74319,44283
12,00,ARUNACHAL PRADESH,Total,50-69,66871,43702,23169,25303,19155,6148
12,00,ARUNACHAL PRADESH,Total,70+,10766,6584,4182,3059,2096,963
12,00,ARUNACHAL PRADESH,Total,Age not stated,873,518,355,406,258,148
12,00,ARUNACHAL PRADESH,Rural,Total,658664,356907,301757,292514,168050,124464
12,00,ARUNACHAL PRADESH,Rural,5-9,60934,31213,29721,16869,8656,8213
12,00,ARUNACHAL PRADESH,Rural,10-14,108202,55071,53131,48341,24832,23509
12,00,ARUNACHAL PRADESH,Rural,15-19,96571,49444,47127,52775,27283,25492
12,00,ARUNACHAL PRADESH,Rural,20-24,79874,41006,38868,41512,22060,19452
12,00,ARUNACHAL PRADESH,Rural,25-29,72435,38401,34034,35442,20055,15387
12,00,ARUNACHAL PRADESH,Rural,30-49,179150,102431,76719,77680,50186,27494
12,00,ARUNACHAL PRADESH,Rural,50-69,51729,33296,18433,17224,13123,4101
12,00,ARUNACHAL PRADESH,Rural,70+,9076,5644,3432,2339,1644,695
12,00,ARUNACHAL PRADESH,Rural,Age not stated,693,401,292,332,211,121
12,00,ARUNACHAL PRADESH,Urban,Total,227281,121506,105775,126037,68616,57421
12,00,ARUNACHAL PRADESH,Urban,5-9,18238,9043,9195,5497,2807,2690
12,00,ARUNACHAL PRADESH,Urban,10-14,31583,15626,15957,16338,8134,8204
12,00,ARUNACHAL PRADESH,Urban,15-19,33525,16403,17122,21449,10522,10927
12,00,ARUNACHAL PRADESH,Urban,20-24,27983,13802,14181,17295,8424,8871
12,00,ARUNACHAL PRADESH,Urban,25-29,26862,14028,12834,15663,8065,7598
12,00,ARUNACHAL PRADESH,Urban,30-49,72078,41141,30937,40922,24133,16789
12,00,ARUNACHAL PRADESH,Urban,50-69,15142,10406,4736,8079,6032,2047
12,00,ARUNACHAL PRADESH,Urban,70+,1690,940,750,720,452,268
12,00,ARUNACHAL PRADESH,Urban,Age not stated,180,117,63,74,47,27
13,00,NAGALAND,Total,Total,1229723,661899,567824,537481,306593,230888
13,00,NAGALAND,Total,5-9,76558,39454,37104,20184,10355,9829
13,00,NAGALAND,Total,10-14,167282,86761,80521,65276,33711,31565
13,00,NAGALAND,Total,15-19,183998,94641,89357,88924,46015,42909
13,00,NAGALAND,Total,20-24,166321,85061,81260,82440,43183,39257
13,00,NAGALAND,Total,25-29,143158,74043,69115,69024,37805,31219
13,00,NAGALAND,Total,30-49,364258,200129,164129,161767,98784,62983
13,00,NAGALAND,Total,50-69,108575,68531,40044,43182,31552,11630
13,00,NAGALAND,Total,70+,18917,12888,6029,6433,5020,1413
13,00,NAGALAND,Total,Age not stated,656,391,265,251,168,83
13,00,NAGALAND,Rural,Total,805544,437247,368297,306186,179418,126768
13,00,NAGALAND,Rural,5-9,46513,24063,22450,9810,5059,4751
13,00,NAGALAND,Rural,10-14,111488,58297,53191,37196,19489,17707
13,00,NAGALAND,Rural,15-19,123882,63991,59891,53524,27846,25678
13,00,NAGALAND,Rural,20-24,109069,56217,52852,48396,25998,22398
13,00,NAGALAND,Rural,25-29,91201,47135,44066,38687,21735,16952
13,00,NAGALAND,Rural,30-49,236727,130940,105787,89941,57196,32745
13,00,NAGALAND,Rural,50-69,72657,46682,25975,24462,18697,5765
13,00,NAGALAND,Rural,70+,13457,9600,3857,3977,3273,704
13,00,NAGALAND,Rural,Age not stated,550,322,228,193,125,68
13,00,NAGALAND,Urban,Total,424179,224652,199527,231295,127175,104120
13,00,NAGALAND,Urban,5-9,30045,15391,14654,10374,5296,5078
13,00,NAGALAND,Urban,10-14,55794,28464,27330,28080,14222,13858
13,00,NAGALAND,Urban,15-19,60116,30650,29466,35400,18169,17231
13,00,NAGALAND,Urban,20-24,57252,28844,28408,34044,17185,16859
13,00,NAGALAND,Urban,25-29,51957,26908,25049,30337,16070,14267
13,00,NAGALAND,Urban,30-49,127531,69189,58342,71826,41588,30238
13,00,NAGALAND,Urban,50-69,35918,21849,14069,18720,12855,5865
13,00,NAGALAND,Urban,70+,5460,3288,2172,2456,1747,709
13,00,NAGALAND,Urban,Age not stated,106,69,37,58,43,15
14,00,MANIPUR,Total,Total,1388620,760287,628333,616818,356245,260573
14,00,MANIPUR,Total,5-9,54239,27852,26387,11849,6071,5778
14,00,MANIPUR,Total,10-14,143233,73752,69481,47531,24548,22983
14,00,MANIPUR,Total,15-19,180446,92569,87877,80381,41749,38632
14,00,MANIPUR,Total,20-24,182229,94059,88170,88711,47320,41391
14,00,MANIPUR,Total,25-29,174781,91770,83011,85642,46763,38879
14,00,MANIPUR,Total,30-49,455117,254282,200835,216676,129446,87230
14,00,MANIPUR,Total,50-69,166672,104890,61782,73935,51361,22574
14,00,MANIPUR,Total,70+,28528,19225,9303,10773,8203,2570
14,00,MANIPUR,Total,Age not stated,3375,1888,1487,1320,784,536
14,00,MANIPUR,Rural,Total,957878,527082,430796,376083,221927,154156
14,00,MANIPUR,Rural,5-9,40846,21111,19735,8226,4231,3995
14,00,MANIPUR,Rural,10-14,104830,54401,50429,31728,16608,15120
14,00,MANIPUR,Rural,15-19,131873,68026,63847,54360,28570,25790
14,00,MANIPUR,Rural,20-24,129835,67647,62188,57729,31461,26268
14,00,MANIPUR,Rural,25-29,119155,63312,55843,52538,29645,22893
14,00,MANIPUR,Rural,30-49,301538,170558,130980,125568,78193,47375
14,00,MANIPUR,Rural,50-69,108243,68164,40079,39247,28373,10874
14,00,MANIPUR,Rural,70+,19234,12539,6695,5825,4329,1496
14,00,MANIPUR,Rural,Age not stated,2324,1324,1000,862,517,345
14,00,MANIPUR,Urban,Total,430742,233205,197537,240735,134318,106417
14,00,MANIPUR,Urban,5-9,13393,6741,6652,3623,1840,1783
14,00,MANIPUR,Urban,10-14,38403,19351,19052,15803,7940,7863
14,00,MANIPUR,Urban,15-19,48573,24543,24030,26021,13179,12842
14,00,MANIPUR,Urban,20-24,52394,26412,25982,30982,15859,15123
14,00,MANIPUR,Urban,25-29,55626,28458,27168,33104,17118,15986
14,00,MANIPUR,Urban,30-49,153579,83724,69855,91108,51253,39855
14,00,MANIPUR,Urban,50-69,58429,36726,21703,34688,22988,11700
14,00,MANIPUR,Urban,70+,9294,6686,2608,4948,3874,1074
14,00,MANIPUR,Urban,Age not stated,1051,564,487,458,267,191
15,00,MIZORAM,Total,Total,309703,174164,135539,52966,34714,18252
15,00,MIZORAM,Total,5-9,12142,6271,5871,657,341,316
15,00,MIZORAM,Total,10-14,28446,14509,13937,3011,1661,1350
15,00,MIZORAM,Total,15-19,43552,22186,21366,5621,3150,2471
15,00,MIZORAM,Total,20-24,45775,23881,21894,7462,4311,3151
15,00,MIZORAM,Total,25-29,40397,21812,18585,7405,4536,2869
15,00,MIZORAM,Total,30-49,100223,59038,41185,20192,13955,6237
15,00,MIZORAM,Total,50-69,33107,22235,10872,7344,5719,1625
15,00,MIZORAM,Total,70+,5904,4117,1787,1247,1027,220
15,00,MIZORAM,Total,Age not stated,157,115,42,27,14,13
15,00,MIZORAM,Rural,Total,123209,71744,51465,18117,12714,5403
15,00,MIZORAM,Rural,5-9,7248,3756,3492,271,145,126
15,00,MIZORAM,Rural,10-14,14204,7393,6811,1589,914,675
15,00,MIZORAM,Rural,15-19,16403,8836,7567,2485,1584,901
15,00,MIZORAM,Rural,20-24,17065,9266,7799,2862,1807,1055
15,00,MIZORAM,Rural,25-29,15337,8754,6583,2568,1740,828
15,00,MIZORAM,Rural,30-49,37025,23037,13988,5985,4545,1440
15,00,MIZORAM,Rural,50-69,13433,9058,4375,2039,1718,321
15,00,MIZORAM,Rural,70+,2437,1606,831,306,254,52
15,00,MIZORAM,Rural,Age not stated,57,38,19,12,7,5
15,00,MIZORAM,Urban,Total,186494,102420,84074,34849,22000,12849
15,00,MIZORAM,Urban,5-9,4894,2515,2379,386,196,190
15,00,MIZORAM,Urban,10-14,14242,7116,7126,1422,747,675
15,00,MIZORAM,Urban,15-19,27149,13350,13799,3136,1566,1570
15,00,MIZORAM,Urban,20-24,28710,14615,14095,4600,2504,2096
15,00,MIZORAM,Urban,25-29,25060,13058,12002,4837,2796,2041
15,00,MIZORAM,Urban,30-49,63198,36001,27197,14207,9410,4797
15,00,MIZORAM,Urban,50-69,19674,13177,6497,5305,4001,1304
15,00,MIZORAM,Urban,70+,3467,2511,956,941,773,168
15,00,MIZORAM,Urban,Age not stated,100,77,23,15,7,8
16,00,TRIPURA,Total,Total,1268601,713499,555102,198577,129143,69434
16,00,TRIPURA,Total,5-9,66014,33904,32110,3569,1875,1694
16,00,TRIPURA,Total,10-14,133105,68731,64374,12806,6717,6089
16,00,TRIPURA,Total,15-19,154407,79842,74565,24110,13453,10657
16,00,TRIPURA,Total,20-24,164091,85830,78261,30643,18236,12407
16,00,TRIPURA,Total,25-29,149063,83243,65820,27299,17653,9646
16,00,TRIPURA,Total,30-49,408414,240573,167841,71145,49234,21911
16,00,TRIPURA,Total,50-69,159331,99883,59448,25825,19441,6384
16,00,TRIPURA,Total,70+,33775,21261,12514,3117,2494,623
16,00,TRIPURA,Total,Age not stated,401,232,169,63,40,23
16,00,TRIPURA,Rural,Total,998741,554074,444667,111473,75094,36379
16,00,TRIPURA,Rural,5-9,59380,30493,28887,2302,1216,1086
16,00,TRIPURA,Rural,10-14,117273,60680,56593,8623,4554,4069
16,00,TRIPURA,Rural,15-19,127610,65830,61780,15930,9095,6835
16,00,TRIPURA,Rural,20-24,131138,68081,63057,19325,12084,7241
16,00,TRIPURA,Rural,25-29,117141,65034,52107,16702,11506,5196
16,00,TRIPURA,Rural,30-49,304365,177607,126758,37446,27838,9608
16,00,TRIPURA,Rural,50-69,113602,69028,44574,9615,7602,2013
16,00,TRIPURA,Rural,70+,27925,17142,10783,1494,1173,321
16,00,TRIPURA,Rural,Age not stated,307,179,128,36,26,10
16,00,TRIPURA,Urban,Total,269860,159425,110435,87104,54049,33055
16,00,TRIPURA,Urban,5-9,6634,3411,3223,1267,659,608
16,00,TRIPURA,Urban,10-14,15832,8051,7781,4183,2163,2020
16,00,TRIPURA,Urban,15-19,26797,14012,12785,8180,4358,3822
16,00,TRIPURA,Urban,20-24,32953,17749,15204,11318,6152,5166
16,00,TRIPURA,Urban,25-29,31922,18209,13713,10597,6147,4450
16,00,TRIPURA,Urban,30-49,104049,62966,41083,33699,21396,12303
16,00,TRIPURA,Urban,50-69,45729,30855,14874,16210,11839,4371
16,00,TRIPURA,Urban,70+,5850,4119,1731,1623,1321,302
16,00,TRIPURA,Urban,Age not stated,94,53,41,27,14,13
17,00,MEGHALAYA,Total,Total,822320,441080,381240,274931,160749,114182
17,00,MEGHALAYA,Total,5-9,35650,17733,17917,5929,3000,2929
17,00,MEGHALAYA,Total,10-14,91347,44869,46478,22372,11248,11124
17,00,MEGHALAYA,Total,15-19,124246,61319,62927,38320,19928,18392
17,00,MEGHALAYA,Total,20-24,117456,59311,58145,40613,21901,18712
17,00,MEGHALAYA,Total,25-29,102344,54715,47629,37290,21395,15895
17,00,MEGHALAYA,Total,30-49,251970,143454,108516,94069,58689,35380
17,00,MEGHALAYA,Total,50-69,82656,50010,32646,31023,21024,9999
17,00,MEGHALAYA,Total,70+,15076,8566,6510,4856,3199,1657
17,00,MEGHALAYA,Total,Age not stated,1575,1103,472,459,365,94
17,00,MEGHALAYA,Rural,Total,473698,263006,210692,123303,78030,45273
17,00,MEGHALAYA,Rural,5-9,21275,10579,10696,2240,1128,1112
17,00,MEGHALAYA,Rural,10-14,54459,26625,27834,9397,4810,4587
17,00,MEGHALAYA,Rural,15-19,73054,36200,36854,17552,9462,8090
17,00,MEGHALAYA,Rural,20-24,67305,34179,33126,18665,10605,8060
17,00,MEGHALAYA,Rural,25-29,59052,32727,26325,17408,10869,6539
17,00,MEGHALAYA,Rural,30-49,142911,86393,56518,42598,29447,13151
17,00,MEGHALAYA,Rural,50-69,46245,30372,15873,13180,10008,3172
17,00,MEGHALAYA,Rural,70+,8492,5382,3110,2083,1573,510
17,00,MEGHALAYA,Rural,Age not stated,905,549,356,180,128,52
17,00,MEGHALAYA,Urban,Total,348622,178074,170548,151628,82719,68909
17,00,MEGHALAYA,Urban,5-9,14375,7154,7221,3689,1872,1817
17,00,MEGHALAYA,Urban,10-14,36888,18244,18644,12975,6438,6537
17,00,MEGHALAYA,Urban,15-19,51192,25119,26073,20768,10466,10302
17,00,MEGHALAYA,Urban,20-24,50151,25132,25019,21948,11296,10652
17,00,MEGHALAYA,Urban,25-29,43292,21988,21304,19882,10526,9356
17,00,MEGHALAYA,Urban,30-49,109059,57061,51998,51471,29242,22229
17,00,MEGHALAYA,Urban,50-69,36411,19638,16773,17843,11016,6827
17,00,MEGHALAYA,Urban,70+,6584,3184,3400,2773,1626,1147
17,00,MEGHALAYA,Urban,Age not stated,670,554,116,279,237,42
18,00,ASSAM,Total,Total,14460591,7979404,6481187,4352497,2636287,1716210
18,00,ASSAM,Total,5-9,933458,474237,459221,75685,39158,36527
18,00,ASSAM,Total,10-14,1709983,876552,833431,346634,177427,169207
18,00,ASSAM,Total,15-19,1779391,942970,836421,588953,315028,273925
18,00,ASSAM,Total,20-24,1729663,883858,845805,612884,336045,276839
18,00,ASSAM,Total,25-29,1664518,887561,776957,565338,327137,238201
18,00,ASSAM,Total,30-49,4587841,2641954,1945887,1546934,991577,555357
18,00,ASSAM,Total,50-69,1702077,1055296,646781,529591,385030,144561
18,00,ASSAM,Total,70+,346393,213009,133384,84215,63499,20716
18,00,ASSAM,Total,Age not stated,7267,3967,3300,2263,1386,877
18,00,ASSAM,Rural,Total,11781858,6506486,5275372,2969373,1835672,1133701
18,00,ASSAM,Rural,5-9,830906,421433,409473,49958,25892,24066
18,00,ASSAM,Rural,10-14,1489489,763002,726487,260043,132928,127115
18,00,ASSAM,Rural,15-19,1501513,799092,702421,446282,240932,205350
18,00,ASSAM,Rural,20-24,1420161,726641,693520,443510,247888,195622
18,00,ASSAM,Rural,25-29,1357575,729475,628100,400651,239935,160716
18,00,ASSAM,Rural,30-49,3598951,2090572,1508379,1010932,676345,334587
18,00,ASSAM,Rural,50-69,1302108,804221,497887,306874,232150,74724
18,00,ASSAM,Rural,70+,275973,169247,106726,49848,38798,11050
18,00,ASSAM,Rural,Age not stated,5182,2803,2379,1275,804,471
18,00,ASSAM,Urban,Total,2678733,1472918,1205815,1383124,800615,582509
18,00,ASSAM,Urban,5-9,102552,52804,49748,25727,13266,12461
18,00,ASSAM,Urban,10-14,220494,113550,106944,86591,44499,42092
18,00,ASSAM,Urban,15-19,277878,143878,134000,142671,74096,68575
18,00,ASSAM,Urban,20-24,309502,157217,152285,169374,88157,81217
18,00,ASSAM,Urban,25-29,306943,158086,148857,164687,87202,77485
18,00,ASSAM,Urban,30-49,988890,551382,437508,536002,315232,220770
18,00,ASSAM,Urban,50-69,399969,251075,148894,222717,152880,69837
18,00,ASSAM,Urban,70+,70420,43762,26658,34367,24701,9666
18,00,ASSAM,Urban,Age not stated,2085,1164,921,988,582,406
19,00,WEST BENGAL,Total,Total,15025848,8782338,6243510,2881005,1789355,1091650
19,00,WEST BENGAL,Total,5-9,583978,301181,282797,41967,22141,19826
19,00,WEST BENGAL,Total,10-14,1207047,622763,584284,145092,75918,69174
19,00,WEST BENGAL,Total,15-19,1741230,934075,807155,293144,157638,135506
19,00,WEST BENGAL,Total,20-24,1878102,1043010,835092,376243,212153,164090
19,00,WEST BENGAL,Total,25-29,1703267,971326,731941,350511,204325,146186
19,00,WEST BENGAL,Total,30-49,5049629,3034749,2014880,1019941,644335,375606
19,00,WEST BENGAL,Total,50-69,2384451,1555542,828909,546289,390693,155596
19,00,WEST BENGAL,Total,70+,459040,308693,150347,103379,79483,23896
19,00,WEST BENGAL,Total,Age not stated,19104,10999,8105,4439,2669,1770
19,00,WEST BENGAL,Rural,Total,6968587,4098221,2870366,664075,447876,216199
19,00,WEST BENGAL,Rural,5-9,351939,179694,172245,10233,5387,4846
19,00,WEST BENGAL,Rural,10-14,691994,354467,337527,40828,21442,19386
19,00,WEST BENGAL,Rural,15-19,951779,517198,434581,92931,52239,40692
19,00,WEST BENGAL,Rural,20-24,945269,542610,402659,108018,67409,40609
19,00,WEST BENGAL,Rural,25-29,804001,480572,323429,91363,61023,30340
19,00,WEST BENGAL,Rural,30-49,2165933,1339906,826027,220287,158947,61340
19,00,WEST BENGAL,Rural,50-69,897343,582917,314426,87011,70302,16709
19,00,WEST BENGAL,Rural,70+,155210,97680,57530,12856,10717,2139
19,00,WEST BENGAL,Rural,Age not stated,5119,3177,1942,548,410,138
19,00,WEST BENGAL,Urban,Total,8057261,4684117,3373144,2216930,1341479,875451
19,00,WEST BENGAL,Urban,5-9,232039,121487,110552,31734,16754,14980
19,00,WEST BENGAL,Urban,10-14,515053,268296,246757,104264,54476,49788
19,00,WEST BENGAL,Urban,15-19,789451,416877,372574,200213,105399,94814
19,00,WEST BENGAL,Urban,20-24,932833,500400,432433,268225,144744,123481
19,00,WEST BENGAL,Urban,25-29,899266,490754,408512,259148,143302,115846
19,00,WEST BENGAL,Urban,30-49,2883696,1694843,1188853,799654,485388,314266
19,00,WEST BENGAL,Urban,50-69,1487108,972625,514483,459278,320391,138887
19,00,WEST BENGAL,Urban,70+,303830,211013,92817,90523,68766,21757
19,00,WEST BENGAL,Urban,Age not stated,13985,7822,6163,3891,2259,1632
20,00,JHARKHAND,Total,Total,10000720,5474214,4526506,1593039,965960,627079
20,00,JHARKHAND,Total,5-9,842492,431685,410807,58868,30590,28278
20,00,JHARKHAND,Total,10-14,1462648,755151,707497,181061,95075,85986
20,00,JHARKHAND,Total,15-19,1268967,684406,584561,232434,129094,103340
20,00,JHARKHAND,Total,20-24,1100219,587663,512556,208538,119424,89114
20,00,JHARKHAND,Total,25-29,993770,544329,449441,178471,106673,71798
20,00,JHARKHAND,Total,30-49,2817266,1595782,1221484,489116,314067,175049
20,00,JHARKHAND,Total,50-69,1258732,728057,530675,206441,144229,62212
20,00,JHARKHAND,Total,70+,217349,125616,91733,31790,23079,8711
20,00,JHARKHAND,Total,Age not stated,39277,21525,17752,6320,3729,2591
20,00,JHARKHAND,Rural,Total,6988351,3838416,3149935,932202,587017,345185
20,00,JHARKHAND,Rural,5-9,647347,329775,317572,38742,20096,18646
20,00,JHARKHAND,Rural,10-14,1124205,580269,543936,124475,65882,58593
20,00,JHARKHAND,Rural,15-19,885574,483616,401958,144481,83467,61014
20,00,JHARKHAND,Rural,20-24,735170,397351,337819,120823,73484,47339
20,00,JHARKHAND,Rural,25-29,668560,372042,296518,102953,65607,37346
20,00,JHARKHAND,Rural,30-49,1902872,1090703,812169,276324,189039,87285
20,00,JHARKHAND,Rural,50-69,858371,490137,368234,106345,76537,29808
20,00,JHARKHAND,Rural,70+,147689,84451,63238,15876,11567,4309
20,00,JHARKHAND,Rural,Age not stated,18563,10072,8491,2183,1338,845
20,00,JHARKHAND,Urban,Total,3012369,1635798,1376571,660837,378943,281894
20,00,JHARKHAND,Urban,5-9,195145,101910,93235,20126,10494,9632
20,00,JHARKHAND,Urban,10-14,338443,174882,163561,56586,29193,27393
20,00,JHARKHAND,Urban,15-19,383393,200790,182603,87953,45627,42326
20,00,JHARKHAND,Urban,20-24,365049,190312,174737,87715,45940,41775
20,00,JHARKHAND,Urban,25-29,325210,172287,152923,75518,41066,34452
20,00,JHARKHAND,Urban,30-49,914394,505079,409315,212792,125028,87764
20,00,JHARKHAND,Urban,50-69,400361,237920,162441,100096,67692,32404
20,00,JHARKHAND,Urban,70+,69660,41165,28495,15914,11512,4402
20,00,JHARKHAND,Urban,Age not stated,20714,11453,9261,4137,2391,1746
21,00,ODISHA,Total,Total,13825024,7865598,5959426,5525278,3359211,2166067
21,00,ODISHA,Total,5-9,658868,336037,322831,81653,43370,38283
21,00,ODISHA,Total,10-14,1577767,804896,772871,461448,235999,225449
21,00,ODISHA,Total,15-19,1903448,996804,906644,875749,465428,410321
21,00,ODISHA,Total,20-24,1811404,973655,837749,833322,466127,367195
21,00,ODISHA,Total,25-29,1641403,913662,727741,738696,429848,308848
21,00,ODISHA,Total,30-49,4335549,2609566,1725983,1861793,1209395,652398
21,00,ODISHA,Total,50-69,1590003,1037091,552912,577569,437944,139625
21,00,ODISHA,Total,70+,267691,171892,95799,79868,61957,17911
21,00,ODISHA,Total,Age not stated,38891,21995,16896,15180,9143,6037
21,00,ODISHA,Rural,Total,10031393,5740445,4290948,3361065,2102935,1258130
21,00,ODISHA,Rural,5-9,519339,262587,256752,37945,19883,18062
21,00,ODISHA,Rural,10-14,1238370,630420,607950,303209,154752,148457
21,00,ODISHA,Rural,15-19,1430955,748726,682229,588041,315335,272706
21,00,ODISHA,Rural,20-24,1324170,718078,606092,538229,309529,228700
21,00,ODISHA,Rural,25-29,1201587,681949,519638,475817,289177,186640
21,00,ODISHA,Rural,30-49,3012578,1853645,1158933,1076004,742577,333427
21,00,ODISHA,Rural,50-69,1093296,712837,380459,294815,235465,59350
21,00,ODISHA,Rural,70+,185530,117674,67856,39011,31217,7794
21,00,ODISHA,Rural,Age not stated,25568,14529,11039,7994,5000,2994
21,00,ODISHA,Urban,Total,3793631,2125153,1668478,2164213,1256276,907937
21,00,ODISHA,Urban,5-9,139529,73450,66079,43708,23487,20221
21,00,ODISHA,Urban,10-14,339397,174476,164921,158239,81247,76992
21,00,ODISHA,Urban,15-19,472493,248078,224415,287708,150093,137615
21,00,ODISHA,Urban,20-24,487234,255577,231657,295093,156598,138495
21,00,ODISHA,Urban,25-29,439816,231713,208103,262879,140671,122208
21,00,ODISHA,Urban,30-49,1322971,755921,567050,785789,466818,318971
21,00,ODISHA,Urban,50-69,496707,324254,172453,282754,202479,80275
21,00,ODISHA,Urban,70+,82161,54218,27943,40857,30740,10117
21,00,ODISHA,Urban,Age not stated,13323,7466,5857,7186,4143,3043
22,00,CHHATTISGARH,Total,Total,3384223,1820621,1563602,422569,245150,177419
22,00,CHHATTISGARH,Total,5-9,271809,141604,130205,14730,7646,7084
22,00,CHHATTISGARH,Total,10-14,436170,226721,209449,40262,21566,18696
22,00,CHHATTISGARH,Total,15-19,405636,210775,194861,51939,27497,24442
22,00,CHHATTISGARH,Total,20-24,389948,201401,188547,54010,28968,25042
22,00,CHHATTISGARH,Total,25-29,340868,183985,156883,47238,26659,20579
22,00,CHHATTISGARH,Total,30-49,1023357,566559,456798,145345,87057,58288
22,00,CHHATTISGARH,Total,50-69,429772,242011,187761,58416,38300,20116
22,00,CHHATTISGARH,Total,70+,83613,45873,37740,10288,7255,3033
22,00,CHHATTISGARH,Total,Age not stated,3050,1692,1358,341,202,139
22,00,CHHATTISGARH,Rural,Total,2094811,1139954,954857,197443,119521,77922
22,00,CHHATTISGARH,Rural,5-9,198227,102686,95541,9533,4941,4592
22,00,CHHATTISGARH,Rural,10-14,315492,163436,152056,24650,13421,11229
22,00,CHHATTISGARH,Rural,15-19,267911,139607,128304,29537,16017,13520
22,00,CHHATTISGARH,Rural,20-24,240640,126210,114430,27865,15912,11953
22,00,CHHATTISGARH,Rural,25-29,203747,114112,89635,23052,14354,8698
22,00,CHHATTISGARH,Rural,30-49,584272,333102,251170,60683,39885,20798
22,00,CHHATTISGARH,Rural,50-69,238874,135730,103144,19354,13169,6185
22,00,CHHATTISGARH,Rural,70+,44387,24376,20011,2650,1743,907
22,00,CHHATTISGARH,Rural,Age not stated,1261,695,566,119,79,40
22,00,CHHATTISGARH,Urban,Total,1289412,680667,608745,225126,125629,99497
22,00,CHHATTISGARH,Urban,5-9,73582,38918,34664,5197,2705,2492
22,00,CHHATTISGARH,Urban,10-14,120678,63285,57393,15612,8145,7467
22,00,CHHATTISGARH,Urban,15-19,137725,71168,66557,22402,11480,10922
22,00,CHHATTISGARH,Urban,20-24,149308,75191,74117,26145,13056,13089
22,00,CHHATTISGARH,Urban,25-29,137121,69873,67248,24186,12305,11881
22,00,CHHATTISGARH,Urban,30-49,439085,233457,205628,84662,47172,37490
22,00,CHHATTISGARH,Urban,50-69,190898,106281,84617,39062,25131,13931
22,00,CHHATTISGARH,Urban,70+,39226,21497,17729,7638,5512,2126
22,00,CHHATTISGARH,Urban,Age not stated,1789,997,792,222,123,99
23,00,MADHYA PRADESH,Total,Total,9808682,5474699,4333983,1257953,758130,499823
23,00,MADHYA PRADESH,Total,5-9,652029,333783,318246,19694,10244,9450
23,00,MADHYA PRADESH,Total,10-14,1225324,634283,591041,120698,63117,57581
23,00,MADHYA PRADESH,Total,15-19,1367441,732108,635333,220669,121090,99579
23,00,MADHYA PRADESH,Total,20-24,1267570,702092,565478,189794,110897,78897
23,00,MADHYA PRADESH,Total,25-29,1005440,562848,442592,141123,84050,57073
23,00,MADHYA PRADESH,Total,30-49,2842920,1645503,1197417,377928,239192,138736
23,00,MADHYA PRADESH,Total,50-69,1184474,712523,471951,155971,106786,49185
23,00,MADHYA PRADESH,Total,70+,251941,145211,106730,30600,21884,8716
23,00,MADHYA PRADESH,Total,Age not stated,11543,6348,5195,1476,870,606
23,00,MADHYA PRADESH,Rural,Total,5329355,2994271,2335084,562738,366897,195841
23,00,MADHYA PRADESH,Rural,5-9,468606,236906,231700,6992,3640,3352
23,00,MADHYA PRADESH,Rural,10-14,841567,431794,409773,71722,37682,34040
23,00,MADHYA PRADESH,Rural,15-19,817854,442875,374979,134747,77262,57485
23,00,MADHYA PRADESH,Rural,20-24,662352,381456,280896,98001,63370,34631
23,00,MADHYA PRADESH,Rural,25-29,502401,295827,206574,64423,44007,20416
23,00,MADHYA PRADESH,Rural,30-49,1386272,827794,558478,141642,105491,36151
23,00,MADHYA PRADESH,Rural,50-69,533058,313152,219906,38580,30533,8047
23,00,MADHYA PRADESH,Rural,70+,113494,62345,51149,6225,4662,1563
23,00,MADHYA PRADESH,Rural,Age not stated,3751,2122,1629,406,250,156
23,00,MADHYA PRADESH,Urban,Total,4479327,2480428,1998899,695215,391233,303982
23,00,MADHYA PRADESH,Urban,5-9,183423,96877,86546,12702,6604,6098
23,00,MADHYA PRADESH,Urban,10-14,383757,202489,181268,48976,25435,23541
23,00,MADHYA PRADESH,Urban,15-19,549587,289233,260354,85922,43828,42094
23,00,MADHYA PRADESH,Urban,20-24,605218,320636,284582,91793,47527,44266
23,00,MADHYA PRADESH,Urban,25-29,503039,267021,236018,76700,40043,36657
23,00,MADHYA PRADESH,Urban,30-49,1456648,817709,638939,236286,133701,102585
23,00,MADHYA PRADESH,Urban,50-69,651416,399371,252045,117391,76253,41138
23,00,MADHYA PRADESH,Urban,70+,138447,82866,55581,24375,17222,7153
23,00,MADHYA PRADESH,Urban,Age not stated,7792,4226,3566,1070,620,450
24,00,GUJARAT,Total,Total,25892341,15059742,10832599,8570571,5181262,3389309
24,00,GUJARAT,Total,5-9,763581,414513,349068,121026,67749,53277
24,00,GUJARAT,Total,10-14,3095887,1685171,1410716,756301,421529,334772
24,00,GUJARAT,Total,15-19,3808223,2129707,1678516,1406994,812093,594901
24,00,GUJARAT,Total,20-24,3529269,1992135,1537134,1343442,775098,568344
24,00,GUJARAT,Total,25-29,3069070,1764955,1304115,1101469,648985,452484
24,00,GUJARAT,Total,30-49,8118910,4860205,3258705,2678170,1661042,1017128
24,00,GUJARAT,Total,50-69,2922233,1859333,1062900,980172,670719,309453
24,00,GUJARAT,Total,70+,479035,293302,185733,149279,104271,45008
24,00,GUJARAT,Total,Age not stated,106133,60421,45712,33718,19776,13942
24,00,GUJARAT,Rural,Total,11448340,6972590,4475750,3031288,1968947,1062341
24,00,GUJARAT,Rural,5-9,262773,138401,124372,20789,11452,9337
24,00,GUJARAT,Rural,10-14,1718150,925688,792462,362765,202040,160725
24,00,GUJARAT,Rural,15-19,2054517,1155696,898821,661401,393537,267864
24,00,GUJARAT,Rural,20-24,1689524,987924,701600,544812,335527,209285
24,00,GUJARAT,Rural,25-29,1338125,824181,513944,393913,258521,135392
24,00,GUJARAT,Rural,30-49,3244501,2133431,1111070,805891,574826,231065
24,00,GUJARAT,Rural,50-69,963268,690272,272996,207145,167218,39927
24,00,GUJARAT,Rural,70+,139459,94504,44955,25016,19736,5280
24,00,GUJARAT,Rural,Age not stated,38023,22493,15530,9556,6090,3466
24,00,GUJARAT,Urban,Total,14444001,8087152,6356849,5539283,3212315,2326968
24,00,GUJARAT,Urban,5-9,500808,276112,224696,100237,56297,43940
24,00,GUJARAT,Urban,10-14,1377737,759483,618254,393536,219489,174047
24,00,GUJARAT,Urban,15-19,1753706,974011,779695,745593,418556,327037
24,00,GUJARAT,Urban,20-24,1839745,1004211,835534,798630,439571,359059
24,00,GUJARAT,Urban,25-29,1730945,940774,790171,707556,390464,317092
24,00,GUJARAT,Urban,30-49,4874409,2726774,2147635,1872279,1086216,786063
24,00,GUJARAT,Urban,50-69,1958965,1169061,789904,773027,503501,269526
24,00,GUJARAT,Urban,70+,339576,198798,140778,124263,84535,39728
24,00,GUJARAT,Urban,Age not stated,68110,37928,30182,24162,13686,10476
25,00,DAMAN & DIU,Total,Total,116629,71260,45369,34602,21856,12746
25,00,DAMAN & DIU,Total,5-9,4216,2273,1943,850,477,373
25,00,DAMAN & DIU,Total,10-14,10349,5450,4899,2785,1487,1298
25,00,DAMAN & DIU,Total,15-19,14632,8506,6126,4741,2648,2093
25,00,DAMAN & DIU,Total,20-24,19145,12368,6777,5394,3391,2003
25,00,DAMAN & DIU,Total,25-29,17524,10886,6638,5132,3249,1883
25,00,DAMAN & DIU,Total,30-49,39580,24796,14784,12143,8169,3974
25,00,DAMAN & DIU,Total,50-69,9531,6013,3518,3057,2096,961
25,00,DAMAN & DIU,Total,70+,1523,887,636,478,325,153
25,00,DAMAN & DIU,Total,Age not stated,129,81,48,22,14,8
25,00,DAMAN & DIU,Rural,Total,28799,16788,12011,7809,4991,2818
25,00,DAMAN & DIU,Rural,5-9,786,399,387,97,57,40
25,00,DAMAN & DIU,Rural,10-14,3644,1873,1771,655,369,286
25,00,DAMAN & DIU,Rural,15-19,4928,2619,2309,1610,875,735
25,00,DAMAN & DIU,Rural,20-24,4704,2685,2019,1470,902,568
25,00,DAMAN & DIU,Rural,25-29,3807,2187,1620,1118,715,403
25,00,DAMAN & DIU,Rural,30-49,8652,5488,3164,2370,1691,679
25,00,DAMAN & DIU,Rural,50-69,1988,1375,613,432,347,85
25,00,DAMAN & DIU,Rural,70+,248,140,108,48,29,19
25,00,DAMAN & DIU,Rural,Age not stated,42,22,20,9,6,3
25,00,DAMAN & DIU,Urban,Total,87830,54472,33358,26793,16865,9928
25,00,DAMAN & DIU,Urban,5-9,3430,1874,1556,753,420,333
25,00,DAMAN & DIU,Urban,10-14,6705,3577,3128,2130,1118,1012
25,00,DAMAN & DIU,Urban,15-19,9704,5887,3817,3131,1773,1358
25,00,DAMAN & DIU,Urban,20-24,14441,9683,4758,3924,2489,1435
25,00,DAMAN & DIU,Urban,25-29,13717,8699,5018,4014,2534,1480
25,00,DAMAN & DIU,Urban,30-49,30928,19308,11620,9773,6478,3295
25,00,DAMAN & DIU,Urban,50-69,7543,4638,2905,2625,1749,876
25,00,DAMAN & DIU,Urban,70+,1275,747,528,430,296,134
25,00,DAMAN & DIU,Urban,Age not stated,87,59,28,13,8,5
26,00,DADRA & NAGAR HAVELI,Total,Total,198983,113211,85772,71516,44256,27260
26,00,DADRA & NAGAR HAVELI,Total,5-9,16291,8548,7743,2808,1483,1325
26,00,DADRA & NAGAR HAVELI,Total,10-14,27389,14470,12919,11167,6062,5105
26,00,DADRA & NAGAR HAVELI,Total,15-19,23680,13249,10431,11199,6498,4701
26,00,DADRA & NAGAR HAVELI,Total,20-24,27492,15893,11599,10523,6328,4195
26,00,DADRA & NAGAR HAVELI,Total,25-29,25451,14684,10767,9238,5771,3467
26,00,DADRA & NAGAR HAVELI,Total,30-49,59701,35586,24115,21595,14626,6969
26,00,DADRA & NAGAR HAVELI,Total,50-69,16591,9580,7011,4495,3191,1304
26,00,DADRA & NAGAR HAVELI,Total,70+,2208,1104,1104,443,272,171
26,00,DADRA & NAGAR HAVELI,Total,Age not stated,180,97,83,48,25,23
26,00,DADRA & NAGAR HAVELI,Rural,Total,110332,61309,49023,39658,24897,14761
26,00,DADRA & NAGAR HAVELI,Rural,5-9,10879,5590,5289,1335,677,658
26,00,DADRA & NAGAR HAVELI,Rural,10-14,18757,9823,8934,7969,4288,3681
26,00,DADRA & NAGAR HAVELI,Rural,15-19,14765,8094,6671,7697,4526,3171
26,00,DADRA & NAGAR HAVELI,Rural,20-24,14874,8512,6362,6404,4018,2386
26,00,DADRA & NAGAR HAVELI,Rural,25-29,12107,7079,5028,4701,3172,1529
26,00,DADRA & NAGAR HAVELI,Rural,30-49,28127,16199,11928,9273,6583,2690
26,00,DADRA & NAGAR HAVELI,Rural,50-69,9520,5395,4125,2073,1518,555
26,00,DADRA & NAGAR HAVELI,Rural,70+,1208,562,646,180,103,77
26,00,DADRA & NAGAR HAVELI,Rural,Age not stated,95,55,40,26,12,14
26,00,DADRA & NAGAR HAVELI,Urban,Total,88651,51902,36749,31858,19359,12499
26,00,DADRA & NAGAR HAVELI,Urban,5-9,5412,2958,2454,1473,806,667
26,00,DADRA & NAGAR HAVELI,Urban,10-14,8632,4647,3985,3198,1774,1424
26,00,DADRA & NAGAR HAVELI,Urban,15-19,8915,5155,3760,3502,1972,1530
26,00,DADRA & NAGAR HAVELI,Urban,20-24,12618,7381,5237,4119,2310,1809
26,00,DADRA & NAGAR HAVELI,Urban,25-29,13344,7605,5739,4537,2599,1938
26,00,DADRA & NAGAR HAVELI,Urban,30-49,31574,19387,12187,12322,8043,4279
26,00,DADRA & NAGAR HAVELI,Urban,50-69,7071,4185,2886,2422,1673,749
26,00,DADRA & NAGAR HAVELI,Urban,70+,1000,542,458,263,169,94
26,00,DADRA & NAGAR HAVELI,Urban,Age not stated,85,42,43,22,13,9
27,00,MAHARASHTRA,Total,Total,57419861,32034959,25384902,19724729,11455478,8269251
27,00,MAHARASHTRA,Total,5-9,2268786,1199230,1069556,427001,227799,199202
27,00,MAHARASHTRA,Total,10-14,5678007,2997765,2680242,1531016,810747,720269
27,00,MAHARASHTRA,Total,15-19,7368786,3968747,3400039,2785964,1494641,1291323
27,00,MAHARASHTRA,Total,20-24,7613327,4139396,3473931,3002122,1667890,1334232
27,00,MAHARASHTRA,Total,25-29,6807080,3724387,3082693,2556589,1449460,1107129
27,00,MAHARASHTRA,Total,30-49,18312138,10475213,7836925,6333288,3825044,2508244
27,00,MAHARASHTRA,Total,50-69,7571166,4498858,3072308,2527182,1626889,900293
27,00,MAHARASHTRA,Total,70+,1599941,918600,681341,495480,314559,180921
27,00,MAHARASHTRA,Total,Age not stated,200630,112763,87867,66087,38449,27638
27,00,MAHARASHTRA,Rural,Total,24378668,14180104,10198564,6072975,3791321,2281654
27,00,MAHARASHTRA,Rural,5-9,872457,460150,412307,85637,46050,39587
27,00,MAHARASHTRA,Rural,10-14,2725904,1439157,1286747,550208,292798,257410
27,00,MAHARASHTRA,Rural,15-19,3780271,2065870,1714401,1188201,657582,530619
27,00,MAHARASHTRA,Rural,20-24,3530969,1987056,1543913,1134047,678282,455765
27,00,MAHARASHTRA,Rural,25-29,2890207,1659293,1230914,825250,516294,308956
27,00,MAHARASHTRA,Rural,30-49,7142231,4385825,2756406,1674183,1149478,524705
27,00,MAHARASHTRA,Rural,50-69,2755631,1763900,991731,506587,375191,131396
27,00,MAHARASHTRA,Rural,70+,603996,373958,230038,90968,64481,26487
27,00,MAHARASHTRA,Rural,Age not stated,77002,44895,32107,17894,11165,6729
27,00,MAHARASHTRA,Urban,Total,33041193,17854855,15186338,13651754,7664157,5987597
27,00,MAHARASHTRA,Urban,5-9,1396329,739080,657249,341364,181749,159615
27,00,MAHARASHTRA,Urban,10-14,2952103,1558608,1393495,980808,517949,462859
27,00,MAHARASHTRA,Urban,15-19,3588515,1902877,1685638,1597763,837059,760704
27,00,MAHARASHTRA,Urban,20-24,4082358,2152340,1930018,1868075,989608,878467
27,00,MAHARASHTRA,Urban,25-29,3916873,2065094,1851779,1731339,933166,798173
27,00,MAHARASHTRA,Urban,30-49,11169907,6089388,5080519,4659105,2675566,1983539
27,00,MAHARASHTRA,Urban,50-69,4815535,2734958,2080577,2020595,1251698,768897
27,00,MAHARASHTRA,Urban,70+,995945,544642,451303,404512,250078,154434
27,00,MAHARASHTRA,Urban,Age not stated,123628,67868,55760,48193,27284,20909
28,00,ANDHRA PRADESH,Total,Total,21583334,12193992,9389342,6344376,3836382,2507994
28,00,ANDHRA PRADESH,Total,5-9,985843,509669,476174,115782,60417,55365
28,00,ANDHRA PRADESH,Total,10-14,2212518,1140322,1072196,565173,287163,278010
28,00,ANDHRA PRADESH,Total,15-19,3138190,1650679,1487511,1050652,554499,496153
28,00,ANDHRA PRADESH,Total,20-24,3085492,1671803,1413689,1038315,583144,455171
28,00,ANDHRA PRADESH,Total,25-29,2591841,1447501,1144340,838481,498114,340367
28,00,ANDHRA PRADESH,Total,30-49,6368580,3837106,2531474,1887033,1246429,640604
28,00,ANDHRA PRADESH,Total,50-69,2483489,1517849,965640,664191,481875,182316
28,00,ANDHRA PRADESH,Total,70+,494506,295283,199223,113967,83106,30861
28,00,ANDHRA PRADESH,Total,Age not stated,222875,123780,99095,70782,41635,29147
28,00,ANDHRA PRADESH,Rural,Total,10862432,6180282,4682150,2361512,1475239,886273
28,00,ANDHRA PRADESH,Rural,5-9,550681,284707,265974,31000,16420,14580
28,00,ANDHRA PRADESH,Rural,10-14,1258989,652393,606596,271257,138864,132393
28,00,ANDHRA PRADESH,Rural,15-19,1768112,953906,814206,528154,287382,240772
28,00,ANDHRA PRADESH,Rural,20-24,1629927,928795,701132,457619,278555,179064
28,00,ANDHRA PRADESH,Rural,25-29,1274158,742051,532107,314178,205362,108816
28,00,ANDHRA PRADESH,Rural,30-49,2897031,1764209,1132822,557059,399263,157796
28,00,ANDHRA PRADESH,Rural,50-69,1146753,662376,484377,153434,115437,37997
28,00,ANDHRA PRADESH,Rural,70+,249983,142829,107154,28809,21487,7322
28,00,ANDHRA PRADESH,Rural,Age not stated,86798,49016,37782,20002,12469,7533
28,00,ANDHRA PRADESH,Urban,Total,10720902,6013710,4707192,3982864,2361143,1621721
28,00,ANDHRA PRADESH,Urban,5-9,435162,224962,210200,84782,43997,40785
28,00,ANDHRA PRADESH,Urban,10-14,953529,487929,465600,293916,148299,145617
28,00,ANDHRA PRADESH,Urban,15-19,1370078,696773,673305,522498,267117,255381
28,00,ANDHRA PRADESH,Urban,20-24,1455565,743008,712557,580696,304589,276107
28,00,ANDHRA PRADESH,Urban,25-29,1317683,705450,612233,524303,292752,231551
28,00,ANDHRA PRADESH,Urban,30-49,3471549,2072897,1398652,1329974,847166,482808
28,00,ANDHRA PRADESH,Urban,50-69,1336736,855473,481263,510757,366438,144319
28,00,ANDHRA PRADESH,Urban,70+,244523,152454,92069,85158,61619,23539
28,00,ANDHRA PRADESH,Urban,Age not stated,136077,74764,61313,50780,29166,21614
29,00,KARNATAKA,Total,Total,24252594,13032885,11219709,7832129,4519095,3313034
29,00,KARNATAKA,Total,5-9,1306324,671726,634598,206401,106584,99817
29,00,KARNATAKA,Total,10-14,2309408,1190806,1118602,582959,299680,283279
29,00,KARNATAKA,Total,15-19,2783894,1450466,1333428,930411,482025,448386
29,00,KARNATAKA,Total,20-24,2999775,1583762,1416013,1063860,574968,488892
29,00,KARNATAKA,Total,25-29,2814269,1482949,1331320,1000446,558250,442196
29,00,KARNATAKA,Total,30-49,7720222,4273343,3446879,2667185,1613216,1053969
29,00,KARNATAKA,Total,50-69,3500733,1943074,1557659,1152408,738377,414031
29,00,KARNATAKA,Total,70+,802663,428116,374547,224335,143605,80730
29,00,KARNATAKA,Total,Age not stated,15306,8643,6663,4124,2390,1734
29,00,KARNATAKA,Rural,Total,10742452,5798397,4944055,2048187,1236259,811928
29,00,KARNATAKA,Rural,5-9,620675,318937,301738,42366,22007,20359
29,00,KARNATAKA,Rural,10-14,1121929,581298,540631,173946,90619,83327
29,00,KARNATAKA,Rural,15-19,1359768,723122,636646,322466,173699,148767
29,00,KARNATAKA,Rural,20-24,1326504,720269,606235,320275,184695,135580
29,00,KARNATAKA,Rural,25-29,1160516,625636,534880,253381,153725,99656
29,00,KARNATAKA,Rural,30-49,3216734,1781571,1435163,625881,404663,221218
29,00,KARNATAKA,Rural,50-69,1540862,839700,701162,255619,171323,84296
29,00,KARNATAKA,Rural,70+,388952,204207,184745,53293,34937,18356
29,00,KARNATAKA,Rural,Age not stated,6512,3657,2855,960,591,369
29,00,KARNATAKA,Urban,Total,13510142,7234488,6275654,5783942,3282836,2501106
29,00,KARNATAKA,Urban,5-9,685649,352789,332860,164035,84577,79458
29,00,KARNATAKA,Urban,10-14,1187479,609508,577971,409013,209061,199952
29,00,KARNATAKA,Urban,15-19,1424126,727344,696782,607945,308326,299619
29,00,KARNATAKA,Urban,20-24,1673271,863493,809778,743585,390273,353312
29,00,KARNATAKA,Urban,25-29,1653753,857313,796440,747065,404525,342540
29,00,KARNATAKA,Urban,30-49,4503488,2491772,2011716,2041304,1208553,832751
29,00,KARNATAKA,Urban,50-69,1959871,1103374,856497,896789,567054,329735
29,00,KARNATAKA,Urban,70+,413711,223909,189802,171042,108668,62374
29,00,KARNATAKA,Urban,Age not stated,8794,4986,3808,3164,1799,1365
30,00,GOA,Total,Total,1126152,587384,538768,741249,395322,345927
30,00,GOA,Total,5-9,55389,28471,26918,19717,10207,9510
30,00,GOA,Total,10-14,98902,51045,47857,60922,31258,29664
30,00,GOA,Total,15-19,104640,54476,50164,77536,39797,37739
30,00,GOA,Total,20-24,116280,61865,54415,81507,42338,39169
30,00,GOA,Total,25-29,118210,60127,58083,82875,42046,40829
30,00,GOA,Total,30-49,403282,208533,194749,280213,148773,131440
30,00,GOA,Total,50-69,189376,102282,87094,117897,69045,48852
30,00,GOA,Total,70+,38742,19887,18855,19902,11490,8412
30,00,GOA,Total,Age not stated,1331,698,633,680,368,312
30,00,GOA,Rural,Total,412842,215406,197436,261781,141675,120106
30,00,GOA,Rural,5-9,19433,9853,9580,5353,2697,2656
30,00,GOA,Rural,10-14,37137,18941,18196,21850,11138,10712
30,00,GOA,Rural,15-19,39408,20277,19131,29838,15245,14593
30,00,GOA,Rural,20-24,42864,22040,20824,31127,15863,15264
30,00,GOA,Rural,25-29,45126,22834,22292,32179,16485,15694
30,00,GOA,Rural,30-49,149332,78053,71279,100396,55164,45232
30,00,GOA,Rural,50-69,65912,36260,29652,35334,21731,13603
30,00,GOA,Rural,70+,13020,6810,6210,5420,3184,2236
30,00,GOA,Rural,Age not stated,610,338,272,284,168,116
30,00,GOA,Urban,Total,713310,371978,341332,479468,253647,225821
30,00,GOA,Urban,5-9,35956,18618,17338,14364,7510,6854
30,00,GOA,Urban,10-14,61765,32104,29661,39072,20120,18952
30,00,GOA,Urban,15-19,65232,34199,31033,47698,24552,23146
30,00,GOA,Urban,20-24,73416,39825,33591,50380,26475,23905
30,00,GOA,Urban,25-29,73084,37293,35791,50696,25561,25135
30,00,GOA,Urban,30-49,253950,130480,123470,179817,93609,86208
30,00,GOA,Urban,50-69,123464,66022,57442,82563,47314,35249
30,00,GOA,Urban,70+,25722,13077,12645,14482,8306,6176
30,00,GOA,Urban,Age not stated,721,360,361,396,200,196
31,00,LAKSHADWEEP,Total,Total,18553,11338,7215,9981,6435,3546
31,00,LAKSHADWEEP,Total,5-9,153,85,68,43,24,19
31,00,LAKSHADWEEP,Total,10-14,938,425,513,413,200,213
31,00,LAKSHADWEEP,Total,15-19,2255,1092,1163,1251,608,643
31,00,LAKSHADWEEP,Total,20-24,2684,1413,1271,1515,806,709
31,00,LAKSHADWEEP,Total,25-29,2633,1490,1143,1456,837,619
31,00,LAKSHADWEEP,Total,30-49,6864,4426,2438,3706,2603,1103
31,00,LAKSHADWEEP,Total,50-69,2761,2187,574,1512,1298,214
31,00,LAKSHADWEEP,Total,70+,252,215,37,74,55,19
31,00,LAKSHADWEEP,Total,Age not stated,13,5,8,11,4,7
31,00,LAKSHADWEEP,Rural,Total,3507,2088,1419,2007,1213,794
31,00,LAKSHADWEEP,Rural,5-9,30,15,15,23,12,11
31,00,LAKSHADWEEP,Rural,10-14,123,50,73,62,24,38
31,00,LAKSHADWEEP,Rural,15-19,440,172,268,243,98,145
31,00,LAKSHADWEEP,Rural,20-24,590,302,288,336,169,167
31,00,LAKSHADWEEP,Rural,25-29,524,292,232,303,167,136
31,00,LAKSHADWEEP,Rural,30-49,1289,863,426,740,509,231
31,00,LAKSHADWEEP,Rural,50-69,475,371,104,278,221,57
31,00,LAKSHADWEEP,Rural,70+,34,22,12,21,12,9
31,00,LAKSHADWEEP,Rural,Age not stated,2,1,1,1,1,0
31,00,LAKSHADWEEP,Urban,Total,15046,9250,5796,7974,5222,2752
31,00,LAKSHADWEEP,Urban,5-9,123,70,53,20,12,8
31,00,LAKSHADWEEP,Urban,10-14,815,375,440,351,176,175
31,00,LAKSHADWEEP,Urban,15-19,1815,920,895,1008,510,498
31,00,LAKSHADWEEP,Urban,20-24,2094,1111,983,1179,637,542
31,00,LAKSHADWEEP,Urban,25-29,2109,1198,911,1153,670,483
31,00,LAKSHADWEEP,Urban,30-49,5575,3563,2012,2966,2094,872
31,00,LAKSHADWEEP,Urban,50-69,2286,1816,470,1234,1077,157
31,00,LAKSHADWEEP,Urban,70+,218,193,25,53,43,10
31,00,LAKSHADWEEP,Urban,Age not stated,11,4,7,10,3,7
32,00,KERALA,Total,Total,8163387,4293120,3870267,3188813,1734057,1454756
32,00,KERALA,Total,5-9,124384,62705,61679,21734,10913,10821
32,00,KERALA,Total,10-14,487556,239994,247562,164088,78390,85698
32,00,KERALA,Total,15-19,984467,479873,504594,394355,187751,206604
32,00,KERALA,Total,20-24,1136808,549608,587200,451745,217414,234331
32,00,KERALA,Total,25-29,920299,433918,486381,365227,176347,188880
32,00,KERALA,Total,30-49,2831951,1477358,1354593,1089354,591318,498036
32,00,KERALA,Total,50-69,1405103,876076,529027,595956,395989,199967
32,00,KERALA,Total,70+,266789,170389,96400,104238,74815,29423
32,00,KERALA,Total,Age not stated,6030,3199,2831,2116,1120,996
32,00,KERALA,Rural,Total,3813471,2013584,1799887,1360343,742683,617660
32,00,KERALA,Rural,5-9,55439,27953,27486,8201,4089,4112
32,00,KERALA,Rural,10-14,230876,112481,118395,73213,34400,38813
32,00,KERALA,Rural,15-19,482727,235551,247176,181418,86526,94892
32,00,KERALA,Rural,20-24,553702,269891,283811,204253,99069,105184
32,00,KERALA,Rural,25-29,449068,213666,235402,163420,79621,83799
32,00,KERALA,Rural,30-49,1330424,702998,627426,462231,255478,206753
32,00,KERALA,Rural,50-69,600789,379126,221663,228828,155085,73743
32,00,KERALA,Rural,70+,107761,70426,37335,37870,27911,9959
32,00,KERALA,Rural,Age not stated,2685,1492,1193,909,504,405
32,00,KERALA,Urban,Total,4349916,2279536,2070380,1828470,991374,837096
32,00,KERALA,Urban,5-9,68945,34752,34193,13533,6824,6709
32,00,KERALA,Urban,10-14,256680,127513,129167,90875,43990,46885
32,00,KERALA,Urban,15-19,501740,244322,257418,212937,101225,111712
32,00,KERALA,Urban,20-24,583106,279717,303389,247492,118345,129147
32,00,KERALA,Urban,25-29,471231,220252,250979,201807,96726,105081
32,00,KERALA,Urban,30-49,1501527,774360,727167,627123,335840,291283
32,00,KERALA,Urban,50-69,804314,496950,307364,367128,240904,126224
32,00,KERALA,Urban,70+,159028,99963,59065,66368,46904,19464
32,00,KERALA,Urban,Age not stated,3345,1707,1638,1207,616,591
33,00,TAMIL NADU,Total,Total,20416270,11000921,9415349,2447163,1410192,1036971
33,00,TAMIL NADU,Total,5-9,793890,405408,388482,71336,36174,35162
33,00,TAMIL NADU,Total,10-14,1807126,922718,884408,184305,92689,91616
33,00,TAMIL NADU,Total,15-19,2641312,1351597,1289715,265081,135501,129580
33,00,TAMIL NADU,Total,20-24,2680610,1355183,1325427,294227,151825,142402
33,00,TAMIL NADU,Total,25-29,2425727,1245556,1180171,286720,155804,130916
33,00,TAMIL NADU,Total,30-49,6492876,3614974,2877902,856022,511568,344454
33,00,TAMIL NADU,Total,50-69,2937213,1734604,1202609,405142,268595,136547
33,00,TAMIL NADU,Total,70+,623776,363306,260470,83084,57299,25785
33,00,TAMIL NADU,Total,Age not stated,13740,7575,6165,1246,737,509
33,00,TAMIL NADU,Rural,Total,8090417,4442859,3647558,568669,344518,224151
33,00,TAMIL NADU,Rural,5-9,324666,166729,157937,16935,8763,8172
33,00,TAMIL NADU,Rural,10-14,817200,420675,396525,49092,25170,23922
33,00,TAMIL NADU,Rural,15-19,1258075,657702,600373,79946,42902,37044
33,00,TAMIL NADU,Rural,20-24,1173036,612644,560392,81902,45244,36658
33,00,TAMIL NADU,Rural,25-29,983963,527759,456204,71717,42961,28756
33,00,TAMIL NADU,Rural,30-49,2324877,1343087,981790,180326,117519,62807
33,00,TAMIL NADU,Rural,50-69,986770,585385,401385,73774,51504,22270
33,00,TAMIL NADU,Rural,70+,215696,125477,90219,14604,10241,4363
33,00,TAMIL NADU,Rural,Age not stated,6134,3401,2733,373,214,159
33,00,TAMIL NADU,Urban,Total,12325853,6558062,5767791,1878494,1065674,812820
33,00,TAMIL NADU,Urban,5-9,469224,238679,230545,54401,27411,26990
33,00,TAMIL NADU,Urban,10-14,989926,502043,487883,135213,67519,67694
33,00,TAMIL NADU,Urban,15-19,1383237,693895,689342,185135,92599,92536
33,00,TAMIL NADU,Urban,20-24,1507574,742539,765035,212325,106581,105744
33,00,TAMIL NADU,Urban,25-29,1441764,717797,723967,215003,112843,102160
33,00,TAMIL NADU,Urban,30-49,4167999,2271887,1896112,675696,394049,281647
33,00,TAMIL NADU,Urban,50-69,1950443,1149219,801224,331368,217091,114277
33,00,TAMIL NADU,Urban,70+,408080,237829,170251,68480,47058,21422
33,00,TAMIL NADU,Urban,Age not stated,7606,4174,3432,873,523,350
34,00,PUDUCHERRY,Total,Total,392292,213582,178710,71665,40809,30856
34,00,PUDUCHERRY,Total,5-9,11110,5672,5438,1399,717,682
34,00,PUDUCHERRY,Total,10-14,32650,16569,16081,4771,2384,2387
34,00,PUDUCHERRY,Total,15-19,51352,25860,25492,7431,3778,3653
34,00,PUDUCHERRY,Total,20-24,55138,26720,28418,8545,4096,4449
34,00,PUDUCHERRY,Total,25-29,50313,24640,25673,7998,4034,3964
34,00,PUDUCHERRY,Total,30-49,132479,75664,56815,26378,15233,11145
34,00,PUDUCHERRY,Total,50-69,49808,32478,17330,12478,8628,3850
34,00,PUDUCHERRY,Total,70+,9184,5824,3360,2612,1911,701
34,00,PUDUCHERRY,Total,Age not stated,258,155,103,53,28,25
34,00,PUDUCHERRY,Rural,Total,80981,45383,35598,5029,3145,1884
34,00,PUDUCHERRY,Rural,5-9,2130,1110,1020,124,71,53
34,00,PUDUCHERRY,Rural,10-14,7634,3851,3783,531,241,290
34,00,PUDUCHERRY,Rural,15-19,13448,6758,6690,511,259,252
34,00,PUDUCHERRY,Rural,20-24,14216,7017,7199,599,294,305
34,00,PUDUCHERRY,Rural,25-29,12049,6284,5765,672,392,280
34,00,PUDUCHERRY,Rural,30-49,23767,14977,8790,1776,1228,548
34,00,PUDUCHERRY,Rural,50-69,6547,4605,1942,685,547,138
34,00,PUDUCHERRY,Rural,70+,1085,718,367,129,112,17
34,00,PUDUCHERRY,Rural,Age not stated,105,63,42,2,1,1
34,00,PUDUCHERRY,Urban,Total,311311,168199,143112,66636,37664,28972
34,00,PUDUCHERRY,Urban,5-9,8980,4562,4418,1275,646,629
34,00,PUDUCHERRY,Urban,10-14,25016,12718,12298,4240,2143,2097
34,00,PUDUCHERRY,Urban,15-19,37904,19102,18802,6920,3519,3401
34,00,PUDUCHERRY,Urban,20-24,40922,19703,21219,7946,3802,4144
34,00,PUDUCHERRY,Urban,25-29,38264,18356,19908,7326,3642,3684
34,00,PUDUCHERRY,Urban,30-49,108712,60687,48025,24602,14005,10597
34,00,PUDUCHERRY,Urban,50-69,43261,27873,15388,11793,8081,3712
34,00,PUDUCHERRY,Urban,70+,8099,5106,2993,2483,1799,684
34,00,PUDUCHERRY,Urban,Age not stated,153,92,61,51,27,24
35,00,ANDAMAN & NICOBAR ISLANDS,Total,Total,257425,142378,115047,72708,41846,30862
35,00,ANDAMAN & NICOBAR ISLANDS,Total,5-9,14096,7110,6986,1958,983,975
35,00,ANDAMAN & NICOBAR ISLANDS,Total,10-14,25476,12995,12481,6651,3331,3320
35,00,ANDAMAN & NICOBAR ISLANDS,Total,15-19,26857,14005,12852,9494,4785,4709
35,00,ANDAMAN & NICOBAR ISLANDS,Total,20-24,29179,15535,13644,9171,4827,4344
35,00,ANDAMAN & NICOBAR ISLANDS,Total,25-29,32609,17622,14987,9716,5320,4396
35,00,ANDAMAN & NICOBAR ISLANDS,Total,30-49,91903,51816,40087,27080,16469,10611
35,00,ANDAMAN & NICOBAR ISLANDS,Total,50-69,32357,20054,12303,7803,5517,2286
35,00,ANDAMAN & NICOBAR ISLANDS,Total,70+,4721,3115,1606,771,579,192
35,00,ANDAMAN & NICOBAR ISLANDS,Total,Age not stated,227,126,101,64,35,29
35,00,ANDAMAN & NICOBAR ISLANDS,Rural,Total,152600,84758,67842,38136,22243,15893
35,00,ANDAMAN & NICOBAR ISLANDS,Rural,5-9,7941,4012,3929,939,474,465
35,00,ANDAMAN & NICOBAR ISLANDS,Rural,10-14,15529,7852,7677,3667,1814,1853
35,00,ANDAMAN & NICOBAR ISLANDS,Rural,15-19,16182,8449,7733,5334,2719,2615
35,00,ANDAMAN & NICOBAR ISLANDS,Rural,20-24,17279,9014,8265,5093,2661,2432
35,00,ANDAMAN & NICOBAR ISLANDS,Rural,25-29,19544,10610,8934,5352,2965,2387
35,00,ANDAMAN & NICOBAR ISLANDS,Rural,30-49,53497,30515,22982,13760,8645,5115
35,00,ANDAMAN & NICOBAR ISLANDS,Rural,50-69,19458,12151,7307,3626,2675,951
35,00,ANDAMAN & NICOBAR ISLANDS,Rural,70+,3077,2099,978,339,274,65
35,00,ANDAMAN & NICOBAR ISLANDS,Rural,Age not stated,93,56,37,26,16,10
35,00,ANDAMAN & NICOBAR ISLANDS,Urban,Total,104825,57620,47205,34572,19603,14969
35,00,ANDAMAN & NICOBAR ISLANDS,Urban,5-9,6155,3098,3057,1019,509,510
35,00,ANDAMAN & NICOBAR ISLANDS,Urban,10-14,9947,5143,4804,2984,1517,1467
35,00,ANDAMAN & NICOBAR ISLANDS,Urban,15-19,10675,5556,5119,4160,2066,2094
35,00,ANDAMAN & NICOBAR ISLANDS,Urban,20-24,11900,6521,5379,4078,2166,1912
35,00,ANDAMAN & NICOBAR ISLANDS,Urban,25-29,13065,7012,6053,4364,2355,2009
35,00,ANDAMAN & NICOBAR ISLANDS,Urban,30-49,38406,21301,17105,13320,7824,5496
35,00,ANDAMAN & NICOBAR ISLANDS,Urban,50-69,12899,7903,4996,4177,2842,1335
35,00,ANDAMAN & NICOBAR ISLANDS,Urban,70+,1644,1016,628,432,305,127
35,00,ANDAMAN & NICOBAR ISLANDS,Urban,Age not stated,134,70,64,38,19,19
